1111111111111111111
1P00000000000000001
1111101111101111011
1100001000100C00001
1111101000101011101
100110100010C001001
1111101111101000001
1000111101111000001
1000100101111011101
1000100101011000E01
1110111101111111101
1000000100000000001
1111111111111111111
