111111111111111111111111111111111111111
1P0C0C00C00C000000000000000000000000001
1001C1000C00000000000000000000000000001
100111000C00000000000000000000000000001
10000C00000100C000000000000000000000001
100000000C00000000000000000000000000001
100000111C00100000000000000000000000001
100011101C00100010000000000000000000001
100010C01C000100100000000000000000000C1
100111001C00001000000000000000000000001
1000C0001C00011000000000000000000000001
1000111111000C0000000000000000000000001
10000C000100011000000000000000000000001
100000000C01011011111111111111100000001
111110100001C11000000001111111000000001
10000C000001111000000000000000000000001
10101111C000000000000000000000000000001
101000011101111100001100000110000000001
111110101001000000000001111111100000001
1C00001010000000000000000000000000000E1
111111111111111111111111111111111111111
